Real Kashmir - Inter Kashi FC
FC Olimpik - PFK Metallurg Bekabad
PFC Minyor Pernik - SFC Etar Veliko Tarnovo
Muglaspor - Silivrispor
Sreenidi Deccan FC - Delhi FC
Isparta 32 Sporu - Batman Petrolspor
PSS Sleman - Persib Bandung
PFC Ludogorets Razgrad II - FK CSKA 1948 II
Makedonikos FC - PAOK Thessaloniki B
Om Al Qutain - AL Arabi
CSKA Sofia II - PFC Dobrudzha Dobrich
PFC Belasitsa Petrich - Pfk Botev Plovdiv II
AL Zulfi - Al-Ain FC (SA)
Al-Jabalain - Al-Najma
El Qanah FC - El Sekka El Hadid
Telecom Egypt - Tanta FC
Myanmar - Indonesia
Negeri Sembilan - Selangor FC
Sporting Alexandria - La Viena FC
KS Pogradeci - KS Burreli
El Dakhleya Sc - Abo Qair Semads
Panionios Athens - Panargiakos FC
FK Hebar Pazardzhik - FC Arda Kardzhali
OFK Belgrade - FK Novi Pazar
Laos - Vietnam
Bahir Dar Kenema FC - Saint George SC
Gol Gohar Sirjan FC - Tractor Sport Club
Yemen - Kuwait
FK Javor Ivanjica - FK Mladost Gat
FK Spartak 1918 Varna - PFC Slavia Sofia
Al Mokawloon Al Arab - El Mansurah
FK IMT Novi Beograd - FK Napredak Krusevac
Turan Tovuz - Shamakhi FK
Jeddah Club - Al-Faisaly FC
AFC Hermannstadt - ASC Otelul Galati
Athens Kallithea FC - APO Levadiakos FC
ACF Fiorentina - SS Lazio
Al-Khaldiya SC - Al-Shabbab
Hadiya Hossana FC - Sidama Bunna SC
KF Tirana - KF Teuta
Al Hussein Irbid - Shabab AL Ordun
FC Polissya Zhytomyr - FC Rukh Lviv
Al Riffa - Al-Ahli SC Manama
Esenler Erokspor - Umraniyespor
FK Radnicki Nis - FK Radnicki 1923 Kragujevac
Gaziantep FK - Caykur Rizespor
Eintracht Frankfurt - RB Leipzig
Amed Sportif Faaliyetler - Sanliurfaspor
Hapoel Rishon Lezion FC - Hapoel Kfar Shalem FC
FK Zeljeznicar Sarajevo - NK Gosk Gabela
Hapoel Ramat Gan Givatayim FC - Maccabi Herzliya
Hapoel Hadera FC - Maccabi Bney Reine
LKS Lodz - MKS Arka Gdynia
Inova Sca - Club Omnisports de Korhogo
Ironi Tiberias - Maccabi Netanya FC
Korona Kielce - Pogon Szczecin
FC Universitatea Cluj - FC CFR 1907 Cluj
FC Utrecht - FC Eindhoven
PSV Eindhoven - Roda JC Kerkrade
Ajax Amsterdam - De Graafschap
Perugia Calcio Spa - Campobasso FC
Giugliano Calcio 1928 - SS Monopoli
Lucchese Libertas 1905 - SS Arezzo
FC Cartagena - Sporting Gijon
FC Metz - USL Dunkerque
AC Monza - Udinese Calcio
Barwell FC - Kettering Town
West Ham United - Wolverhampton Wanderers
Northampton Town - Peterborough United
Getafe CF - Espanyol Barcelona
CA Tigre - Independiente Rivadavia
Estrela Amadora - FC Arouca
Home - Away
Humble Lions FC - Mount Pleasant FC
Argentinos Juniors - CA San Lorenzo de Almagro
CA Belgrano de Cordoba - Estudiantes de La Plata
CA Huracan - CA Platense
CA Independiente Avellaneda - Atletico Tucuman
Arnett Gardens FC - Harbour View FC
Guadalupe FC - Inter San Carlos
Madura United - Semen Padang FC
SC Farense - Santa Clara
Al-Batin - Ohod Medina
Neom SC - Al-Arabi SC (SA)
Al-Adalah - Al-Tai
AFK Csikszereda Miercurea Ciuc - Metaloglobus Bucuresti
GNK Dinamo Zagreb - Celtic Glasgow
Girona FC - Liverpool FC
Rotherham United - Tranmere Rovers FC
